0 0 1 1 0 0 1 0 0 0
0 0 0 0 0 0 1 0 0 0
e 0 0 1 0 1 1 1 0 0
0 0 1 0 0 0 1 0 0 0
0 0 1 0 1 0 1 0 0 0
0 0 1 0 1 0 0 0 0 0
0 0 1 0 0 0 1 1 0 0
0 0 1 0 0 0 1 x 0 0
0 0 1 1 1 0 1 1 1 0
0 0 0 0 1 0 0 0 0 0